1 1 0 0 0 0 0 0 1 1 1 1 1 0 0 2 0 0 0 0 0 0 0 0 1 1 0 0 
4 1 1 1 0 0 0 0 1 1 1 1 1 0 0 2 0 0 0 0 0 0 0 0 1 1 0 0 
4 0 0 0 0 0 0 0 1 1 0 0 0 0 1 1 0 0 0 0 0 0 1 1 2 2 1 1 
4 0 0 0 0 0 0 0 1 1 0 0 0 0 1 1 0 0 0 0 0 0 1 1 2 2 1 1 
4 4 0 0 2 2 4 5 1 1 2 2 0 0 1 1 0 0 0 0 1 1 0 0 1 1 0 0 
0 0 0 0 2 2 6 7 1 1 2 2 0 0 1 1 0 0 0 0 1 1 0 0 1 1 0 0 
0 0 0 0 4 5 0 0 1 1 4 5 1 1 1 1 0 0 2 2 0 0 0 0 0 0 2 2 
0 0 0 0 6 7 0 0 1 1 6 7 1 1 1 1 0 0 2 2 0 0 0 0 0 0 2 2 
1 1 1 1 4 5 1 1 0 0 4 5 0 0 0 0 0 1 0 0 0 0 0 0 0 0 0 0 
1 1 1 1 6 7 1 1 0 0 6 7 0 0 0 0 1 1 0 0 0 0 0 0 0 0 0 0 
1 1 0 0 2 2 1 1 4 5 2 2 1 1 0 0 1 0 0 0 1 1 1 1 0 0 0 0 
1 1 0 0 2 2 1 1 6 7 2 2 0 0 2 2 0 0 0 0 1 1 1 1 0 0 0 0 
1 1 2 2 0 0 1 1 0 0 0 0 0 2 0 0 1 1 0 0 1 1 4 5 4 5 0 0 
1 1 2 2 0 0 1 1 0 0 0 0 2 2 0 0 0 0 2 2 1 1 6 7 6 7 0 0 
1 1 1 1 1 1 1 1 0 0 0 0 2 0 0 0 0 0 0 0 0 0 4 5 1 1 1 1 
1 1 1 1 1 1 1 1 0 0 0 0 1 1 1 1 0 0 0 0 0 0 6 7 1 1 1 1 
0 0 0 0 0 0 0 0 0 0 0 0 1 8 9 1 0 0 0 0 0 0 0 0 1 1 1 1 
0 0 0 0 0 0 0 0 0 0 0 0 1 9 9 1 0 0 0 0 0 0 0 0 1 1 1 1 
