0 0 0 3 0 0 0 0 0 0 0 0 3 0 0 0 0 3 0 0 0 0 0 0 3 0 0 0 
0 0 0 3 0 0 0 0 0 0 0 0 3 0 0 0 0 3 0 0 0 0 0 0 3 0 0 0 
0 0 0 3 0 0 0 0 0 0 0 0 3 0 0 0 0 3 0 0 0 0 0 0 3 0 0 0 
0 0 0 0 3 0 0 0 0 0 0 0 3 0 0 0 0 3 0 0 0 0 0 3 0 0 0 0 
0 0 0 0 0 3 0 0 0 0 0 0 3 0 0 0 0 3 0 0 0 0 3 0 0 0 0 0 
3 0 0 0 0 0 3 0 0 0 0 0 3 0 0 0 0 3 0 0 0 3 0 0 0 0 0 3 
0 3 0 0 0 0 0 3 0 0 0 0 3 0 0 0 0 3 0 0 3 0 0 0 0 0 3 0 
0 0 3 0 0 0 0 0 3 0 0 0 3 0 0 0 0 3 0 3 0 0 0 0 0 3 0 0 
0 0 0 3 3 0 0 0 0 3 0 0 3 0 0 0 0 3 3 0 0 0 0 3 3 0 0 0 
0 0 0 0 0 3 0 0 0 0 3 0 3 0 0 0 0 3 3 0 0 0 3 0 0 0 0 0 
0 0 0 0 0 3 0 0 0 0 1 3 3 1 1 1 1 3 3 0 0 0 3 0 0 0 0 0 
0 0 0 0 0 0 3 0 0 1 1 0 0 0 0 0 0 1 1 0 0 0 3 0 0 0 0 0 
0 0 0 0 0 0 0 3 1 1 1 0 0 0 0 0 0 1 1 0 0 3 0 0 0 0 0 0 
0 0 0 0 0 0 0 0 3 3 0 0 0 0 0 0 0 0 3 3 3 0 0 0 0 0 0 0 
0 0 0 0 0 0 0 3 0 0 0 0 0 0 0 0 0 0 0 0 0 3 0 0 0 0 0 0 
0 0 0 0 0 0 3 0 0 0 0 0 1 1 1 1 0 0 0 0 0 0 3 0 0 0 0 0 
0 0 0 0 0 3 0 0 0 0 0 0 1 8 9 1 0 0 0 0 0 0 0 3 0 0 0 0 
0 0 0 0 3 0 0 0 0 0 0 0 1 9 9 1 0 0 0 0 0 0 0 0 3 0 0 0 
