0 0 0 0 0 0 0 6 0 4 0 0 0 0 0 4 4 0 0 0 0 5 5 0 0 0 0 0 
0 0 0 0 0 0 6 0 0 4 0 0 0 0 0 4 4 0 0 0 0 5 5 0 0 0 0 0 
0 0 0 0 0 6 0 0 0 4 0 0 0 0 0 4 4 0 0 0 0 5 5 0 0 0 0 0 
0 0 0 0 3 0 0 0 0 4 0 0 0 0 0 1 1 0 0 0 0 3 3 0 0 0 0 0 
0 0 0 0 3 0 0 0 0 1 0 0 0 0 0 1 1 0 0 0 0 3 3 0 0 0 0 0 
0 0 0 0 3 0 0 0 0 3 0 0 0 0 0 1 1 0 0 0 0 5 5 0 0 0 0 0 
0 0 0 0 3 0 0 0 0 1 0 0 0 0 0 1 1 0 0 0 0 3 3 0 0 0 0 0 
0 0 0 0 0 1 1 0 0 3 0 0 0 0 0 1 1 0 0 4 4 4 4 0 0 0 0 0 
0 0 0 0 0 0 0 1 1 1 0 1 1 1 1 1 1 4 4 0 0 4 4 0 0 0 0 0 
0 0 0 0 0 0 0 0 0 0 4 1 1 1 1 4 4 0 0 0 0 1 1 0 0 0 0 0 
1 1 1 0 0 0 0 0 0 0 0 0 0 0 0 0 0 0 0 0 0 1 1 0 0 0 0 0 
1 1 1 0 0 0 0 0 0 0 0 0 0 0 0 0 0 0 0 3 3 0 0 0 0 0 0 0 
1 1 1 0 0 0 0 0 0 0 0 0 0 0 0 0 0 3 3 0 0 0 0 0 0 0 0 0 
1 1 1 0 0 0 0 4 1 1 4 1 0 0 0 0 4 0 0 0 0 0 0 0 0 0 0 0 
1 1 1 0 0 0 0 1 4 1 1 4 0 0 0 0 4 0 0 0 0 0 0 0 0 0 0 1 
0 1 1 1 1 1 1 1 1 0 0 0 1 1 1 1 0 0 0 0 0 0 0 1 1 1 1 0 
0 0 0 1 0 1 0 1 1 0 0 0 1 8 9 1 0 0 0 0 0 0 1 0 1 1 0 1 
0 0 0 1 0 1 0 1 1 0 0 0 1 9 9 1 0 0 0 0 0 1 0 1 1 0 1 0 
